#####A#######
#         # #
# ####### # #
#   #     # #
# # # ##### #
# # #       #
# # ### #####
# #     #   #
##### # # # #
#   # #   # #
# # # ##### #
# #   #     #
#######B#####